WE ./textures/west.xpm
EA ./textures/east.xpm

F  240,        240,      240

C     50        ,50      ,50

SO                   textures/south.xpm
NO ./textures/north.xpm

1111111111111
1f00000000001
1000000000001
10000000000011111
10000000000000001
10000111110000001
10000100010000001
10000100000000001
10000100010000001
10000110100000001
10000100010000001
10000100010000001
10000110110000001
10000100010000001
10000100010000001
10000110110000001
10000100010000001
100001000100000011
100001101100000001
100000000000000001
100000000000000001
100001110110000001
100001000010000001
100000000010000001
100001000010000001
100001101110000001
100000101000000001
100000101000000001
100000000000000001
1000W0000000011111
10000000000001
11111111111111
