WE textures/west.png
EA ./textures/east.png

F  141,        1,      126

C 222,183,183

SO                   textures/south.png
NO textures/north.png

               111111111111111111111111
               10000000000000000000001111111
               11000000000010011100000000001                        111111111111111111
               11000000111100000000001111111                        1000000000000000011111111111
               11000000000100000100011                111  111      1000000000000000000000000001
       111111111111111111111100010001111111111        101  101      10000000000000011111111110011
       1000000011111111111011000100111111110011111111110111101111111100000000000000111      100011
       1000000010000001111011111101111111000000000000000000000000000000000001000000001      100011111111111111111
      11110000000000000000000000011111100000111111111111111101111111100000000000000111       10000000000000000001
     11000000000100000111111101111111111010000111          101      1000000000000001 11111111001111111111111111111
  11100100000001111111110100000000000000010000111       111101      1000000000000001 10000000001
11100111011111111111111100000011111000000011111         100001      1000000000000001 10111111001
100011 101     1111111111110001000000011111             111111      11111111110011111101    1001
110011 101     1111111111110001000100000001                                  11001100001    1001
 110011101     1111111111111111110111111111                                   1100111111    1001
  11001101                      101                                            110011       10S1
   1100001                      101                                             110011      100111111111
    1111011111111111111111111111101111111111111111111111111111111111111111111111111001111111100000000001
       1000000000000000000000000000000000000000000000000000000000000000000000000000000000000000111111101
       11111111111111111111111111011111111111111111111111111111111111111111111111111110111111111     101
                                101                                                  101             101
                                101                                                  101             101
                                101                                                  101             101
                                101                                                  101             101
                                101                                                  1011111111111111101
                                101                                                  1000000000000000001
                                101                                                  1111111111111111111
                                101
                                111

test
