NO ./img/north.xpm
EA ./img/east.xpm
SO ./img/south.xpm
WE ./img/west.xpm

F 86,125,70
C 135,206,235

11111111111111
10000000000001
10000400000001
10000000000001
100000E0000001
-0000000000001
10000000000001
10000000000001
11111111111111
