NO ./textures/north.xpm
EA ./textures/east.xpm
SO ./textures/south.xpm
WE ./textures/west.xpm

F 86,125,70
C 135,206,235

11111111111111
10000000000001
10000000000001
10000000000001
100000E0000001
00000000000001
10000000000001
10000000000001
11111111111111
