WE ./img/west.xpm
EA ./img/east.xpm

F  240,        240,      240

C     50        ,50      ,50

SO                   img/south.xpm
NO ./img/north.xpm

1111111111111
1000000000001
1000000000001
10000000000011111
10000000000000001
10000111110000001
10000100010000001
10000100020000001
10000100010000001
10000112100000001
10000100010000001
10000100010000001
10000112110000001
10000100010000001
10000100010000001
10000112110000001
10000100010000001
100001000100000011
100001121100000001
100000000000000001
100000000000000001
100001112110000001
100001000010000001
100002000010000001
100001000010000001
100001101110000001
100000101000000001
100000121000000001
100000000000000001
1000W0000000011111
10000000000001
11111111111111
